############
#          #
# # ###### #
### ##   # #
#    # # # #
# ##   #   #
#  ####### #
##   #   # #
####   # # #
######## # #
#          #
############